11111
1CCC1
10E01
10011
11P11
11111
